necessità: che necessitano
pesci: pesca
tendono: tendente
visitare il sito: visita
attendere: in attesa
battere: bussando
scrivere a mano: scrittura a mano
roll: rolling
riferimento: rinvio
perdona: perdonando
risposta: rispondendo
per quanto riguarda: per quanto riguarda
sonno: dormire
si incontrano: incontro
fumo: il fumo
resistere: resistere
touch: tocca
morso: mordere
obiettivo: obiettivo
discutere: discutere
mangiare: mangiare
spiegare: spiegazione
proibire: vietando
andiamo
vex: vessare
sollevare: innalzamento
indicare: indicando
macinare: macinazione
lasciare: lasciando
riconoscere: riconoscere
prendere in considerazione: considerando
scrittura: scrittura
menzione: menzionando
fare: fare
dire: raccontare
bagnato: bagnatura
congelamento: frostbiting
fissare: fissaggio
guardare: guardare
recare: cuscinetto
battere: battendo
Mer: matrimonio
soffrire: la sofferenza
unire: l'adesione
godere: godendo
Guadagno: guadagnando
rappresentare: che rappresenta
sedersi: seduta
Base: basando
razza: allevamento
abitare: abitazione
cambiamento: cambiamento
cadere: cadere
trasmissione: trasmissione
piombo: leader
close: chiusura
affare: si tratta
luce: illuminazione
essere: essere
pensare: pensare
puzza: puzzolente
ottenere: ottenere
guardare: guardare
Sting: pungente
imparare: imparare
scoppio: scoppio
strizzare: estorsione
trarre in inganno: fuorviante
magra: si appoggia
rifiutare: il rifiuto
prosperare: fiorente
preferiscono: preferendo
a piedi: a piedi
fare: fare
prestare: prestito
salto: saltare
raccogliere: la raccolta
speranza: la speranza
ricordate: ricordando
cucire: cucire
connect: collegamento
misura: misurazione
Set: impostazione
buttare: lancio
Wake: il risveglio
nuoto: nuoto
bottino: rovinare
paga: paga
esperienza: vivere
colloquio: parlando
Velocità: eccesso di velocità
lay: posa
dipendere: a seconda
vincere: vincere
capannone: spargimento
predire: predire
vedi: vedere
stare in piedi: in piedi
congelare: il congelamento
prendere: prendere
vestito: suiting
dimenticare: foregetting
bind: binding
sgattaiolare: furtivamente
preoccupazione: per quanto riguarda
abbandonerò: abbandonare
coinvolgere: coinvolgere
Break: la rottura
aiuto: aiuto
corretto: correzione
fornire: la consegna
Relazione: la segnalazione
sorriso: sorridente
trasportare: trasporta
muoversi: in movimento
accesa: la discesa
Limite: limitazione
Anello: squillo
Semina: semina
Supporto: supporto
identificare: identificazione
soothsay: soothsaying
stretta: tenuta
comprendono: compresi
fuga: fuga
sling: imbracatura
supponiamo: supponendo
Slink: slinking
sparare: le riprese
scorrimento: strisciante
tessuto: tessitura
sarà: disposto
scottature: scottature
influenza: influenzando
proteggere: proteggere
esprimere: che esprime
costruire: costruzione
smettere: smettere
chiara: schiarimento
ringraziare: ringraziare
pulita: pulizia
ritirare: il ritiro
ascolta: ascolta
sciogliere: fusione
origliare: overhearing
Soggiorno: il soggiorno
rispettare: costante
conto: contabilità
forza: forzatura
taglio: taglio
stabilirsi: assestamento
Design: progettazione
escursione: escursionismo
produrre: la produzione
realizzare: realizzare
applica: l'applicazione
rivelare: rivelando
cause: provocando
ultima: durata
conteggio: conteggio
save: risparmio
studio: lo studio
amore: amare
rasatura: rasatura
colpire: colpire
strappo: strappo
meraviglia: Domandarsi
treno: la formazione
incantesimo: l'ortografia
in diretta: soggiorno
Fling: lanciando
consistere: consistente
danni: danni
fuoriuscita: si rovescia
arrivare: in arrivo
vestito: vestirsi
scommessa: scommesse
rilasciare: rilasciando
bastone: attaccare
migliorare: il miglioramento
credere: credere
aggiungi: l'aggiunta di
influenzare: interessano
salire: in aumento
leggi: la lettura
sviluppare: in via di sviluppo
preset: preimpostazione
ricezione: la ricezione di
offerta: offerta
estendere: estendentesi
gioco: gioco
immersioni: diving
offerta: offerta
sapere: sapere
spendere: la spesa
pass: passa
perdere: perdere
male: male
Piano: progettazione
RID: liberare
sanguinare: sanguinamento
taglio: taglio
vestire: abbigliamento
diffusione: diffusione
atto: recitazione
intende: l'intenzione
preoccupazione: preoccuparsi
grido: Gridare
trovati: fondazione
capire: la comprensione
appaiono: apparendo
gestire: la manipolazione
combattere: combattimento
misunderstand: equivoco
gestire: la gestione
Hide: nascondere
bere: bere
caccia: caccia
intarsio: intarsio
accadere: succede
luogo: posizionare
sorpasso: il sorpasso
copia: la copia
servire: servire
girare: tornitura
Cook: cucina
dimostrare: dimostrando
risata: ride
voto: il voto
suggerire: suggerendo
subaffittare: subaffitto
aggrapparsi: aggrappati
falciare: falciatura
giuro: giurando
divisa: splitting
si lamentano: lamentarsi
proprio: possedere
provare: provare
sudore: sudorazione
salita: arrampicata
volto: fronte
stampa: premendo
ordinamento: l'ordinamento
dare: dare
uso: utilizzando
eseguire: in esecuzione
molla: molleggio
sciopero: colpisce
sopravvivere: sopravvivere
risposta: risposta
accompagnamento: Raccolto
scorrevole: scorrevole
pubblicare: editoria
prevedere: prevedendo
avviso: se ne accorga
venire: arrivando
slay: uccisione
divide: dividere
sembrare: apparente
ammettere: ammettendo
cercare: cercare
sostituire: sostituzione
piangere: piangere
rimangono: rimanenti
stringa: tesatura
conferma: conferma
d'accordo: accordo
riflettere: riflettente
tenere: mantenere
permettersi: offrendo
sorgere: derivante
riguardare: relativa
calci: calci
busto: busting
fornire: fornire
tirare: tirando
diventare: diventare
curva: flessione
eseguire: eseguire
commit: commettere
attenzione: la cura
maglia: lavoro a maglia
osare: osare
domanda: impegnativo
seguire: seguente
Controllo: controllare
immaginare: immaginando
Costo: costing
Sweep: spazzare
ridurre: la riduzione
Finitura: finitura
informare: informando
ingresso: immettere
incoraggiare: incoraggiare
espressi: fusione
suono: suono
richiedono: richiedendo
bruciare: bruciore
risultato: risultante
può: fustigazione
cattura: cattura
ripetere: ripetizione
Hang: impiccagione
trattenere: ritenuta
distruggere: distruggere
raggiungere: arrivare
chiuso: chiusura
completo: completando
negare: negando
fornitura: fornitura
alimentazione: alimentazione
di spinta: spinta
sentire: sensazione
separata: separazione
obiettare: Discussione
previsione: previsione
promessa: la promessa
cry: pianto
Carica:
crescere: crescere
aumento: crescente
affermazione: rivendicando
usura: indossare
esaminerà: esame
Test: test
accettare: accettando
tremare: agitazione
Shine: brillante
portare: portare
disegnare: disegno
si aspettano: in attesa
evitare: evitare
aperta: apertura
copertura: copre
fallire: in mancanza di
ecco: contemplando
guidare: guida
subire: sottoposti
descrivere: descrivendo
scegliere: scegliere
vento: avvolgimento
forma: formatura
confrontare: il confronto
impedire: la prevenzione
Preparazione: preparare
come: gradire
passo: a grandi passi
creare: la creazione
presente: presentazione
Record: la registrazione
ottenere: ottenimento
inizio: a partire
dire: dire
shrink: restringimento
sega: segare
chiedere: chiedere
danza: la danza
croce: crossing
odore: smelling
inginocchiarsi: in ginocchio
mettere: mettere
rimuovere: la rimozione
link: collegando
contatto: contatto
overdraw: overdrawing
spiedo: sputi
sconvolto: sconvolgente
vendita: vendita
rotazione: filatura
mente: badando
vogliono: vogliono
rubare: il furto
lasciare: lasciare
ritorno: il ritorno
parlare: parlare
sveglia: risveglio
contribuire: contribuendo
fessura: taglio
organizzare: organizzazione
Punto: Indicare
tendere: sforzandosi
cadere: cadere
attacco: attacco
negozio: lo shopping
odiare: odiare
inviare: l'invio
appartengono: appartenenza
acquistare: acquisto
desiderio: che desiderano
introdurre: introduzione
attivare: abilitazione
uccidere: uccidere
spettacolo: che mostra
viaggio: viaggiare
sentire: l'udito
gonfiarsi: gonfiore
Testa: rubrica
oscillazione: oscillazione
Surf: surf
pattino: ferratura
lavoro: lavorare
successo: riuscire
sogno: sognare
scoperta: scoperta
mark: marcatura
lavandino: affonda
striscia: strippaggio
battistrada: calpestio
salto: salto
volare: volare
contenere: contenente
cantare: il canto
resto: riposa
trattamento: trattamento
Ride: in sella
mettere in guardia: attenzione
decidere: decidere
telefono: chiamando
smettere: arresto
interlay: interlaying
consentire: permettendo
hanno: avere
Stato: affermando
raggiungere: il raggiungimento
intraprendere: impresa
Push: spinge
adattarsi: raccordo
Condividi: condivisione
ordine: ordinazione
die: morire
lavaggio: lavaggio
significa: significato
scavare: scavo
esistono: esistente
colpo: soffiando
trovare: trovare
invitare: invitante
errore: confondere
controllare: controllo
questione: importando
riempimento: riempimento
piegare: pieghevole
insegnare: l'insegnamento
inizio: a partire
Continua: continua
clap: applausi
scompare: scomparendo
perdere: manca
bugia: menzogne
verificarsi: si verificano
