necessità: necessità
pesci: pesci
tende: tende
visitare il sito: visite
attendere: attese
battere: urti
scrivere a mano: handwrites
rotolo rotoli:
riferimento: si riferisce
perdona: perdona
risposta: risposte
Regard: saluti
sonno: posti letto
rispondere: si riunisce
fumo: fuma
sopportare: Resiste
tocco: tocchi
morso: morsi
obiettivo: obiettivi
discutere: discute
mangiare: mangia
spiegare: spiega
proibire: proibisce
andare: va
Vex: irrita
aumentare: rilanci
indicare: indica
macinare: macina
lasciare: foglie
riconoscere: riconosce
prendere in considerazione: considera
scrivere: scrive
citare: menziona
fare: fa
dire: dice
bagnate: bagna
congelamento: geloni
legatura: caletta
guardare: sguardi
orso: gli orsi
battere: battiti
Mer: novelli
soffre: soffre
join: unisce
godere: gode
GAIN: guadagni
rappresentare: rappresenta
sedersi: si siede
di base: basi
razza: razze
abitare: abita
cambiamenti: Variazione
cadere: Gocce
di trasmissione: le trasmissioni
piombo: lead
chiudi: chiude
affare: Offerte
luce: luci
essere: è
pensare: pensa
puzzare: puzza
ottenere: ottiene
guarda gli orologi
Sting: punture
imparare: impara
scoppio: scoppia
strizzare: Wrings
trarre in inganno: inganna
magra: si appoggia
rifiutare: rifiuta
prosperare: prospera
preferiscono: preferisce
a piedi: passeggiate
fare: marche
prestare: presta
bisestili: salti
raccogliere: raccoglie
speranza: la speranza
ricordate: ricorda
cucire: cuce
connect: collega
misura: misure
set: set
buttare: getta
Wake: scie
nuotare: nuota
rovinare: bottino
pagare: paga
esperienza: esperienze
Discussione: i colloqui
velocità: velocità
laici: stabilisce
dipendere: depends
win: vittorie
capannone: capannoni
predire: predice
vedi: vede
stare in piedi: stand
freeze: si blocca
prendere: prende
tuta: abiti
dimenticare: dimentica
bind: lega
nascosto: si intrufola
riguardano: le preoccupazioni
abbandonerò: abbandona
coinvolgere: comporta
Break: break
aiuto: aiuta
corrette: corregge
consegnare: trasferimento
segnalare: i rapporti
Smile: sorrisi
trasportare: trasporta
spostare: muove
accesa: si posa
limite: limiti
anello: Anelli
seminare: scrofe
SUPPORTO: i supporti
identificare: identifica
soothsay: soothsays
tenere: tiene
comprendono: include
fuga: fugge
fionda: imbracature
supponiamo: suppone
Slink: slinks
sparare: germogli
scorrimento: brividi
tessuto: trame
Will: testamenti
scottature: scottature solari
Influenza: influenze
proteggere: protegge
esprimere: esprime
costruire: costruisce
quit: chiude
Cancella: cancella
ringrazio: grazie
pulito: pulisce
ritirare: ritira
ascolta: ascolta
sciogliere: si scioglie
origliare: origlia
Soggiorno: soggiorni
rispettare: dimora
conto: conti
forza: forze
tagliare: tagli
risolvere: si deposita
design: disegni
escursione: escursioni
produrre: produce
realizzare: si rende conto
applicare: si applica
rivelare: rivela
Causa: le cause
ultima: dura
contare: conta
salva: salva
di studio: studi
amore: ama
barba: rade
colpire: colpi
strappo: lacrime
wonder: meraviglie
treno: treni
incantesimo: magie
vivere le vite
Fling: scaglia
consistere: consiste
danni: danni
fuoriuscita: fuoriuscite
arrivare: arriva
vestiti: abiti
scommessa: le scommesse
rilasciare: rilasci
Stick: bastoni
migliorare: migliora
credere: crede
aggiungere: aggiunge
influenzare: interessa
salire: aumenti
leggi: legge
sviluppare: sviluppa
preimpostati: preset
ricezione: riceve
di offerta: le offerte
estendere: estende
gioca: gioca
immersione: immersioni
offerta: offerte
sapere: sa
spendere: spende
pass: passaggi
perdere: perde
male: fa male
space: piani
RID: RID
sanguinare: sanguinamenti
taglio: cesoie
vestire: vestiti
Spread: spread
ACT: atti
intenzione: intende
preoccupazione: le preoccupazioni
gridare: grida
trovate: Trovati
comprendere: capisce
appare: appare
gestire: maniglie
combattere: scontri
fraintendere: fraintende
gestire: gestisce
nascondere: pelli
bere: bevande
caccia: caccia
intarsio: intarsi
accadere: accade
Luogo: posti
sorpasso: sorpassi
copia: copie
servire: serve
girare: giri
Cook: cuochi
dimostrare: dimostra
ridere: ride
voto: voti
suggerire: suggerisce
subaffittare: subaffitti
aggrapparsi: si aggrappa
falciare: falcia
giuro: giura
split: Divide
lamentarsi: si lamenta
proprio: possiede
provare: cerca
Sudore: sudorazione
salita: salite
faccia facce:
press: presse
ordinamento: tipi
dare: dà
uso: usi
eseguire: corre
molla: molle
Strike: scioperi
sopravvivere: sopravvive
risposta: risposte
accompagnamento: picconi
diapositive: scivoli
pubblicare: pubblica
prevedere: prevede
Avviso: le comunicazioni
venire: arriva
uccidere: uccide
divide divide:
sembrare: sembra
ammettere: ammette
cercare: cerca
sostituzione: sostituisce
piangete: piange
rimangono: resti
stringa: stringhe
conferma: conferma
d'accordo: concorda
riflettere: riflette
mantenere: mantiene
permettersi: ulteriore offre
sorgere: nasce
riguardare: riguarda
calci: calci
busto: busti
fornire: fornisce
tirare: tira
diventare: diventa
curvatura: curve
eseguire: esegue
commit: impegna
cura: se ne frega
maglia: maglia
osare: osa
domanda: richieste
seguire: segue
di controllo: controlli
immaginare: immagina
costo: i costi
spazzata: spazza
ridurre: riduce
Finitura: finiture
informare: informa
ingresso: ingressi
incoraggiare: incoraggia
Cast: calchi
suono: suoni
richiede: Richiede
burn: ustioni
Risultato: i risultati
possono: lattine
cattura: cattura
ripetere: ripete
Hang: si blocca
trattenere: witholds
distruggere: distrugge
raggiungere: raggiunge
chiuse: chiude
completare: completa
negare: nega
alimentazione: forniture
alimentazione: i feed
spinta: spinte
sentire: si sente
separate: separa
obiettare: argomenta
previsione: previsioni
promessa: promesse
cry: grida
carica: Costi
crescere: cresce
Aumenta: aumenta
dichiarano: rivendicazioni
usura: indossa
esaminare: esamina
prova: test
accetta: accetta
tremare: scuote
Shine: brilla
portare: porta
disegnare: disegna
si aspettano: si aspetta
evitare: evita
aprire: apre
copertura: coperture
fallire: non riesce
ecco: vede
unità: unità
subire: subisce
descrivere: descrive
scegliere: sceglie
vento: venti
forma: le forme
confrontare: confronta
impedire: impedisce
Preparazione: prepara
come: piace
falcata: passi avanti
creare: crea
presenti: presents
record: record
ottenere: ottiene
START: avvia
dire: dice
shrink: restringe
sega: seghe
chiedere: chiede
danza: danze
cross: traverse
odore: odori
inginocchiarsi: si inginocchia
mettere: puts
Rimuovi: rimuove
Link: link
Contatti:
overdraw: amplifica
sputare: spiedi
sconvolto: disturbi
vendono: vende
di spin: spin
mente: mente
vuole: vuole
rubare: ruba
lascia: lascia
ritorno: I ritorni
parlare: parla
svegli: si sveglia
contribuire: contribuisce
fessura: feritoie
organizzare: organizza
punto: punti
lottare: si sforza
cadere: cadute
attacco: attacchi
Shop: negozi
odiare: odia
inviare: invia
appartengono: frazione
acquistare: acquisti
desiderio: auguri
introdurre: introduce
enable: abilita
uccidere: uccide
Mostra: spettacoli
viaggio: viaggi
sentire: ascolta
gonfiarsi: si gonfia
testa: teste
oscillazione: altalene
di surf: surf
scarpa: scarpe
di lavoro: lavori
successo: riesce
sogno: sogni
scoprire: scopre
Mark: marchi
lavandino: lavelli
striscia: strisce
battistrada: gradini
salto: salta
mosca: mosche
contenere: contiene
cantano: canta
riposo: resti
trattare: ossequi
Ride: giostre
mettere in guardia: avverte
decide: decide
chiamata: chiamate
Stop: interrompe
interlay: interfalde
consentire: permette
avere: ha
statali: stati
conseguire: Si ottiene
intraprendere: si impegna
spingere: spinge
montare: si adatta
Condividi: azioni
ordine: ordini
die: muore
lavare: lavaggi
significare: mezzi
dig: scavi
esiste: esiste
colpo: colpi
trovare: trova
invitare: inviti
errore: gli errori
controllare: controlli
materia: le questioni
compilare: riempimenti
piegare: pieghe
insegnare: insegna
inizio: inizia
Continua: continua
clap: applausi
scompaiono: sparisce
perdere: manca
Lie: menzogna
verificarsi: verifica
