detto dire
sviluppato: sviluppare
ha spiegato: spiegare
affumicato: fumo
continuato: continua
stridden: falcata
rispose: risposta
iscritto: unire
rispetto: confronta
creato: creare
svegliato: Wake
considerato: per quanto riguarda
risvegliato: sveglia
minded: mente
acquistato: acquistare
aperto: aperto
ha chiesto: chiedere
ha detto: dire
promessa: la promessa
mostrato: spettacolo
puliti: pulito
aggrappato: si aggrappano
eliminato: chiaro
fed: mangimi
lavata: lavata
organizzato: organizzare
soothsaid: soothsay
esistito: esistono
morso: morso
snuck: furtivo
sbaglia: errore
in onda: in onda
sped: Velocità
avvertito: warn
fatto fare
viaggiato: viaggio
visitato: visita
sorto: sorgere
preoccupato: preoccupazione
esaminato: esamina
sorrise: sorriso
agito: atto
a sinistra: lasciare
durata: dal vivo
bagnato: bagnato
impedito: prevenire
richiesto: la domanda
quivi: stand
goduto: godere
affondato: sink
sung: cantare
wed: Mer
perdonato: perdona
parlato: parlare
suonava: suono
introdotto: introdurre
ringraziato: Grazie
tornato: il ritorno
bound: bind
infilate: stringa
piallati: Piano
provata: dimostrare
ha rivelato: rivelare
soffermato: abitare
parlate: parlare
fondata: trovati
consisteva: consistono
superato: sorpasso
calci: calcio
durata: ultima
avuto: hanno
forzata: la forza
battibecco: sputo
raffica: raffica
Quaresima: prestare
sostituito: sostituire
preferito: Preferisco
deciso: decidere
coinvolti: coinvolgere
ottenuto: ottenere
giocato: Gioca
rise: risata
frainteso: misunderstand
odore: odore
ottenuto: ottenere
chiesti: Meraviglia
set: set
previsto: previsioni
provato: provare
scelta: scegliere
congelati: congelare
testato: Test
pubblicato: rilascio
incontrato: incontro
testa: testa
inginocchiato: inginocchiarsi
contribuito: contribuire
bussato: colpo
toccata: touch
formato: modulo
addestrato: treno
apparso: appaiono
raggiunto: raggiungere
ha esultato: salto
oscillato: altalena
rasato: radersi
finito: finitura
strappato: tear
indicazione: informare
tuffato: dive
spostato: mossa
capannone: capannone
atteso: si aspettano
danneggiati: danni
frostbitten: congelamento
trasportato: trasportare
dimenticata: dimenticare
riposato: resto
migliorata: migliorare
confermato: conferma
data: dare
soffiato: colpo
influenzato: influenza
ristretto: shrink
segnalati: rapporto
fatto: fare
prosperato: prosperare
misurata: misura
appuntita: Punto
immaginato: immaginate
gestito: gestire
fuggito: fuga
falciata: falciare
commesso: commit
sperato: la speranza
esperto: esperienza
eseguito: eseguire
registrati: record di
incrociati: croce
votato: voto
giurata: swear
sollevato: aumentare
pensiero pensato
verificato: si verificano
quit: quit
seguita: seguire
ferita: vento
guadagnato: Guadagno
udito: sentire
distrutta: distruggere
supportato: Supporto
chiuso: chiudi
tosato: shear
pubblicato: pubblicare
costruzione: costruire
finalizzato: obiettivo
mantenuta: tenere
completato: completa
tenuto: tenere
raccolta: raccogliere
atteso: attendere
negato: negare
cucite: cucire
iniziata: begin
preoccupato: preoccupazione
taglia taglia
descritto: descrivere
ha dichiarato: Stato
scritto a mano: scrivere a mano
flung: Fling
cotta: cuoco
caccia: caccia
causato: causa
cambiato: il cambiamento
correlati: RELATE
contattato: contatto
bruciata dal sole: scottature
colpire: colpire
passeggiato: escursione
richiesta: richiedono
copiato: copy
piaciuto: come
controllata controllo
significava: media
di proprietà: proprio
studiati: studio
risolta: accontentarsi
nuotato: swim
scommessa: scommessa
chiamato: Chiamata
inclusi: includere
riconosciuto: riconoscere
perso perdere
ascoltato: ascolta
subito: soffrire
considerato: prendere in considerazione
sospesa: spring
spazzato: spazzata
raggiunto: realizzare
tracolla: sling
seminato: scrofa
vestita: vestire
abbandonato: abbandonare
guidato: unità
sembrava: sembrano
resistito: resistere
leggi leggi
trattati: trattare
bloccato: bastone
preset: preset
speso: spendere
offerta: offerta
slunk: slink
aggiunto: aggiungi
laminati: rotolo
amato: l'amore
curato: tendono
ha insegnato: insegnare
montato: fit
male male
sentito: feel
guardato: cerca
RID: liberarsi
combattuto: lotta
nascosto: nascondere
adatto: tuta
rimosso: rimuovi
discusso: discutere
Spread: spread
rimasto: restano
proibito: vietare
trovato Trovare
limitata: limite
passato: passaggio
ramo: Anello
ricevuto: ricevere
scomparso: scompaiono
Hung: blocco
ballato: ballo
ridotto: ridurre
Bled: bleed
subaffittare: subaffittare
ha ammesso: ammettere
indicata: indicare
alighted: scendere
cavalcato: corsa
caduto: goccia
: Spalato
di cui: consultare
sudore: il sudore
realizzato: realizzare
nato: Orso
offerta: offerta
uccisi: slay
uccisi: uccidere
rimasto: rimanere
ubriaco: drink
previsto: Foresee
ricercato: chiedere
portato: portare
corri corri
notato: avviso
aumentato: alba
progettati: il design
lavorato: il lavoro
scritta: scrivere
lamentava: lamentano
rappresentato: conto
catturato: catch
insinuato: scorrimento
vestito: vestito
Vieni vieni
suggerito: suggeriscono
fornito: fornitura
visto: vedi
fissato: Fissi
prodotto: la produzione
ripetuto: repeat
scelto: selezionamento
rimasto: lie
pescato: pesce
spogliato: striscia
di cui: lay
verificati: Controllo
invitati: invitare
scoperto: scopri
busto: busto
ritirato: prelevare
corretta: corretto
a maglia: maglia
puzzava: puzza
riflessa: riflettere
diventare: diventare
supposto: supponiamo
scalato: salita
attaccato: attacco
servito: servire
intrapresa: intraprendere
identificato: identificare
gestito: gestire
colpiti: influenzare
affrontato: face
capito: capire
caduti: caduta
presa: prendere
punse: pungere
presentato: presenti
In comune: la quota
bruciate: bruciare
enabled: abilita
d'accordo: d'accordo
attenuto: rispettare
navigato: Surf
trodden: battistrada
salvato: salva
andata: go
splendeva: shine
destinato: l'intenzione
costo: Costo
carica: carica
scoperto: overdraw
spun: spin
applaudito: clap
farro: incantesimo
getto: cast
sostenuto: Argue
sopravvissuto: sopravvivere
scavato: dig
riuscito: successo
immessa: Ingresso
colpito: sciopero
chiuso: chiuso
rispose: rispondere
posto: posto
disegnato: draw
di spinta: spinta
sforzati: si sforzano
consegnato: consegnare
allevato: razza
ordinato: sort
risultato: risultato
esteso: estendere
aiutato: aiutare
acquisti: negozio
importava: la materia
evitare: Evitare
necessario: necessità
contati: count
ordinato: ordine
battuta: battito
imparato: imparare
condizione: fornire
interlacciata: interlay
appoggiò: magra
bent: curva
contrariata: Vex
pieno: riempire
viziato: rovinare
accettati: accetta
rappresentata: rappresentano
dormiva: il sonno
arrivato: arrivare
rifiutato: rifiuti
scivolato: slide
caned: può
venduti: vendere
strizzato: strizzare
volato: volare
successo: accadere
fermato: stop
sat: SIT
cresciuto: crescere
desiderato: desiderare
diviso: dividere
gridò: cry
subita: subire
metti metti
premuto: stampa
incoraggiato: incoraggiare
contemplato: ecco
sognato: sogno
fallito: fail
terra: grind
separate: separata
menzionato: menzione
pianse: piangete
osato: osare
voluto: want
guardato: orologio
volontà: volontà
creduto: credere
a pagamento: pagare
sconvolto: sconvolto
mangiato: mangiare
gridò: grido
coperta: la copertura
rubata: rubare
predetto: predire
sentito: origliare
offerta: permettersi
camminato: camminare
lasciare: lasciare
tessuto: tessuto
fessura: slit
intarsiato: intarsio
rotto: rottura
led: piombo
scossa: shake
saltato: salto
piegata: fold
base: base
consentito: consentire
apparteneva: appartengono
odiato: odio
collegato: collegare
rovesciato: spill
utilizzato: l'uso
colpo: sparare
stato: essere
curato: la cura
spedito spedire
girato: turno
segato: sega
morto: die
calzati: shoe
collegato: Link
segnato: mark
gettato: tiro
indossato: usura
espresso: esprimere
gonfio: swell
dipendeva: depend
trattenuto: trattenere
nota: il know
preparati: preparare
aumentato: aumento
fuorviato: indurre in errore
contenuto: contengono
protetta: proteggere
vinto: vittoria
fusa: melt
tirato: tirare
Lit: la luce
trattati: affare
applicata: applicare
ricordato: ricordare
spinta: spinta
rivendicato: reclamo
avviato: inizio
perdere: Miss
