causando: causa
utilizzando: uso
controllo: Controllo
Immissione: Ingresso
collocazione: posto
capacità: tenere
Rivestimento: copertura
tesatura: stringa
contabilità: conto
gestione: gestione
in mancanza: fail
mancante: Miss
diventando: diventare
l'ordinamento: sort
movimento: mossa
raggiungere: realizzare
lavaggio: lavata
tendente: tendono
fornitura: fornitura
ferratura: shoe
soffiaggio: colpo
apertura: aperto
binding: bind
keeping: mantenere
composto: Consista
a confronto: confronti
fondazione: trovati
che necessitano di: necessità
basando: base
gestione: gestire
cerca: chiedere
Disegno: tiraggio
di misurazione: misura
ripetizione: ripetizione
formazione: treno
audace: il coraggio
di fumare: il fumo
adesione: unire
che interessano: influenzare
controllo: controllare
esprimendo: esprimere
previsione: previsioni
indossare: indossare
scavo: dig
aumentando: aumento
accettando: accettare
significato: media
taglio:
sbagliare: errore
vivente: live
combustione: bruciare
prendere: prendere
subaffitto: subaffitto
tra cui: includere
contatto: contatto
puzzolente: puzza
avendo: hanno
test: Test
atto a soddisfare: vestito
bagnante: bagnato
tiro: spara
giuramento: giurate
progettazione: il design
bere: bere
perdere: perdere
guida:
splitting: split
trekking: escursione
sorprendente: sciopero
commettere: commit
rilascio: rilascio
spinning: spin
volendo: want
broadcasting: trasmissioni
raggiungendo: arrivare
scelta: scegliere
affermando: Stato
pagare: pagare
falciatura: falciare
sorridendo: smile
avvolgimento: vento
vedendo: vedi
correzione: corretto
indicando: indicare
distruggere: distruggere
dannoso: danni
fustigazione: può
in aumento: aumento
servizio: Servire
linking: Link
contenente: contengono
consegna: consegnare
fare: fare
apparente: sembrano
slinking: slink
estendentesi: estendere
odiare: odio
dicendo: dire
abbigliamento: vestire
esistente: esistono
dealing: affare
comprensione: capire
in ginocchio: inginocchiarsi
volare: volare
ridendo: risata
seguenti: seguire
portante: trasportare
sostenendo: Argue
mostra: spettacolo
voto: voto
cattura: cattura
rifiutando: rifiuti
completando: completa
succedendo: accadere
perdonare: perdona
promettente: promessa
riflettendo: riflettere
fissaggio: fasten
aiutare: aiutare
matrimonio: Mer
incontro: incontro
cura: la cura
mira: obiettivo
posa: lay
aggiungendo: aggiungi
frostbiting: congelamento
attacco: attacco
Conoscere: Know
l'intenzione: intende
rubare: rubare
limitazione: limite
spinta: spinta
creazione: creare
se ne accorga: avviso
forzatura: forza
scottature: scottature
ricarica: carica
amare: l'amore
per quanto riguarda: per quanto riguarda
pressatura: stampa
abilitazione: attivare
seduta: sit
mordere: morso
pensiero: pensare
spandimento: spread
offrendo: permettersi
piegatura: piega
rivelando: rivelare
rendicontazione: rapporto
portando: portare
intestazione: testa
assestamento: Settle
ottenendo: ottenere
aggrappato: si aggrappano
veglia: veglia
congelamento: freeze
affermando: reclamo
alla ricerca: cerca
spiegando: spiegare
di fusione: sciogliere
rimanenti: restano
laminazione: rotolo
permettendo: consentire
a cavallo: giro
visita: visita
Cottura: cuoco
identificazione: identificare
appartenenza: appartengono
overhearing: origliare
godendo: godere
lo studio: studio
apparendo: appaiono
l'invio: invia
insegnamento: teach
dicendo: raccontare
pesca: pesce
puntamento: il punto
in piedi: stare in piedi
warning: mettere in guardia
Chiusura: chiudi
essere: essere
eccesso di velocità: velocità
scoppio: scoppio
in via di sviluppo: lo sviluppo
copia: copia
chiedendo: chiedere
ritorno: il ritorno
menzionare: parlare
ricordare: ricordare
ortografia: incantesimo
offerta: offerta
descrivendo: descrivere
che rappresenta: rappresentano
formando: modulo
risveglio: sveglia
supponendo: supponiamo
coinvolgendo: implicano
interlaying: interlay
recitazione: atto
risposta: risposta
Alimentazione: alimentazione
scrittura: scrivere
chiedo: chiedo
sonno: il sonno
proteggere: proteggere
agitazione: shake
vedendo: ecco
lancio: tiro
di gioco: il gioco
sbarco: scendere
importando: la materia
continuando: continua
decidere: decidere
imbracatura: sling
risposta: risposta
costruzione: costruire
gonfiore: swell
in crescita: crescita
macinazione: macinare
organizzazione: organizzare
riempimento: riempire
assillante: Vex
immaginazione: immaginare
mangiare: mangiare
predizione: predire
rottura: rottura
oscillazione: altalena
calci: calcio
lamentarsi: si lamentano
preferendo: Preferisco
svolta: turno
incoraggianti: incoraggiare
si verificano: si verificano
pungente: pungere
morire: die
preparazione: preparare
andare: go
mentire: Bugia
vendita: sell
in attesa: attendere
discutere: discutere
arresto: stop
ammettendo: ammettere
climbing: salita
leader: piombo
strizzare: strizzare
smettere: quit
Leaping: salto
attendere: vieni
impresa: intraprendere
rasatura: radere
sognare: sogno
riferimento: riferimento
locazione: lasciare
piallatura: Piano
running: correre
risultante: risultato
affondamento: sink
surf: Surf
prevedendo: Foresee
calpestio: battistrada
seconda: depend
negando: negare
arrivare: arrivare
apprendimento: imparare
montaggio: fit
parlare: parlare
raccolta: raccogliere
illuminazione: luce
preoccupante: preoccupazione
presentando: presente
sensazione: sensazione
sconvolgente: sconvolto
pubblicazione: pubblicare
relativa: RELATE
realizzando: realizzare
la registrazione: record di
scomparendo: scompaiono
spingere: spingere
molleggio: spring
richiede: richiedono
divisione: dividere
tessitura: tessuto
ritenuta: trattenere
considerando: prendere in considerazione
ordinazione: ordine
derivante: sorgere
condimento: vestito
raccolta: raccogliere
colpire: colpire
ascolta: ascolta
fornendo: fornire
disposti: volontà
simpatia: come
riconoscendo: riconoscere
conteggio: conteggio
suono: suono
piangendo: piangete
shopping: negozio
scrittura: scrivere a mano
uccisione: uccidere
attraversamento trasversale:
a piedi: passeggiata
odore: odore
conferma: conferma
lucente: shine
ringraziando: grazie
fiorente: prosperano
nuoto: nuoto
lasciando: lasciare
impostazione: set
sperando: la speranza
Scommesse: scommessa
marcatura: mark
l'introduzione di: introdurre
incollaggio: bastone
taglio: sega
pulizia: pulire
prestiti: dare
taglio: slit
ritiro: ritirare
preregolazione: preset
piegatura: curva
equivoco: misunderstand
in attesa: si aspettano
bussare: battere
cucire: cucire
riposo: resto
scoperta: scoperta
l'esame: esame
supporto: Supporto
toccante: touch
cambiamento: il cambiamento
costante: rispettare
vietando: vietare
riducendo: ridurre
la sofferenza: soffrire
fuorviante: mislead
caduta: caduta
evitando: evitare
squillo: Anello
strippaggio: striscia
guardare: guardare
casting: getto
eseguire: eseguire
di lavoro: il lavoro
parlando: parlate
la spesa: spendere
prevenzione: evitare
appoggiandosi: magra
canto: cantare
overdrawing: overdraw
ricevere: ricevere
mettendo: mettere
viaggiare: viaggiare
lavoro a maglia: maglia
risparmio: salva
Cuscinetto: bear
invitante: invitare
sorpassi: sorpasso
salto: salto
sputare: sputo
soothsaying: soothsay
cercando: provare
tirando: tirare
abitazione: abitare
rimozione: rimuovere
acquisti: acquistare
concordando: d'accordo
partenza: inizio
suggerendo: suggeriscono
dono: dare
superstite: sopravvivere
applicando: applicare
busting: busto
piangendo: cry
guastarsi: rovinare
striding: falcata
gridando: grido
fase: sottopongono
ottenendo: ottenere
sanguinamento: bleed
Intarsio: intarsio
miglioramento: migliorare
abbandono: abbandonare
che uccide: slay
lettura: leggere
valutazione dei costi: il costo
riuscendo: successo
male: male
durata: ultima
clearing: chiaro
separazione: separata
raising: aumentare
Finitura: finitura
resistere: resistere
contribuendo: contribuire
scorrevole: scorrevole
chiusura: chiuso
sforzo: si sforzano
Sneaking: furtivo
per quanto riguarda: la preoccupazione
disinfestazione: RID
spargimento: spill
in fuga: fuga
foregetting: dimenticare
Semina: scrofa
stare: rimanere
produzione: produrre
udito: sentire
vincente: vittoria
nascondere: nascondere
Influenza: l'influenza
pestaggio: battere
caccia: caccia
lotta: lotta
diving: immersioni
passaggio: passaggio
offerta: offerta
danza: la danza
collegamento: collegare
custodia dei: mente
Possedendo proprio
informare: informare
lacerazione: tear
chiamata: chiamata
vivendo: l'esperienza
appeso: appendere
trattare: trattare
condivisione: condivisione
Allevamento: razza
credere: credere
risultato: trovare
making: fare
restringimento: shrink
inizio: inizio
flinging: Fling
spazzamento: spazzata
esigente: la domanda
che desiderano: desiderare
dimostrando: dimostrare
sostituzione: sostituire
guadagnando: Guadagno
sudorazione: il sudore
caduta: goccia
strisciante: scorrimento
spargimento: capannone
fronte: Fronte
tranciatura: shear
applausi: clap
