Afghanistan: Kabul
Albania: Tirana
Algeria: Algeri
Andorra: Andorra la Vella
Angola: Luanda
Antigua e Barbuda: St. Giovanni
Argentina: Buenos Aires
Armenia: Yerevan
L'Australia: Canberra
Austria: Vienna
Azerbaijan: Baku
Bahamas: Nassau
Bahrain: Al-Manama
Bangladesh: Dacca
Barbados: Bridgetown
Bielorussia: Minsk
Belgio: Bruxelles
Belize: Belmopan
Benin: Porto-Novo
Bhutan: Thimphu
Bolivia: Sucre
Bosnia ed Erzegovina: Sarajevo
Botswana: Gaborone
Brasile: Brasília
Brunei: Bandar Seri Begawan
Bulgaria: Sofia
Burkina Faso: Ouagadougou
Burundi: Bujumbura
Cambogia: Phnom Penh
Camerun: Yaoundé
Canada: Ottawa
Capo Verde: Praia
Repubblica Centrafricana: Bangui
Ciad: N'Djamena
Cile: Santiago
Cina: Pechino
Colombia: Santafé de Bogotá
Comore: Moroni
Repubblica Democratica del Congo: Kinshasa
Repubblica del Congo: Brazzaville
Costa Rica: San José
Costa d'Avorio: Yamoussoukro
Croazia: Zagabria
Cuba: L'Avana
Cipro: Lefkosia
Repubblica Ceca: Praga
Danimarca: Copenaghen
Gibuti: Gibuti
Dominica: Roseau
Repubblica Dominicana: Santo Domingo
Timor Est: Dili
Ecuador: Quito 1
Egitto: Il Cairo
El Salvador: San Salvador
Guinea equatoriale: Malabo
Eritrea: Asmara
Estonia: Tallinn
Etiopia: Addis Abeba
Figi: Suva
Finlandia: Helsinki
Francia: Paris
Gabon: Libreville
Gambia: Banjul
Georgia: Tbilisi
Germania: Berlino
Ghana: Accra
Grecia: Atene
Grenada: St. Giorgio
Guatemala: Città del Guatemala
Guinea: Conakry
Guinea-Bissau: Bissau
Guyana: Georgetown
Haiti: Port-au-Prince
Honduras: Tegucigalpa
Ungheria: Budapest
Islanda: Reykjavik
India: Nuova Delhi
Indonesia: Giacarta
Iran: Teheran
Iraq: Baghdad
Irlanda: Dublino
Israele: Gerusalemme
Italia: Roma
Giamaica: Kingston
Giappone: Tokyo
Jordan: Amman
Kazakhstan: Astana
Kenya: Nairobi
Kiribati: Tarawa
Corea del Nord: Pyongyang
Korea: Seoul
Kosovo: Pristina
Kuwait: Kuwait
Kirghizistan: Bishkek
Laos: Vientiane
Lettonia: Riga
Libano: Beirut
Lesotho: Maseru 173
La Liberia: Monrovia
Libia: Tripoli
Liechtenstein: Vaduz
Lituania: Vilnius
Lussemburgo: Luxembourg
Macedonia: Skopje
Madagascar: Antananarivo
Lilongwe: Malawi
Malesia: Kuala Lumpur
Maldive: Malé
Mali: Bamako
Malta: Valletta
Isole Marshall: Majuro
Mauritania: Nouakchott
Mauritius: Port Louis
Messico: Città del Messico
Micronesia: Palikir 11
Moldova: Chisinau
Monaco: Monaco
Mongolia: Ulaan Baatar
Montenegro: Podgorica
Marocco: Rabat
Mozambico: Maputo
Myanmar: Rangoon
Namibia: Windhoek
Nauru: Yaren
Nepal: Kathmandu
Olanda: Amsterdam
Nuova Zelanda: Wellington
Nicaragua: Managua
Niger: Niamey
La Nigeria: Abuja
Norvegia: Oslo
Oman: Muscat
Pakistan: Islamabad
Palau: Koror
Panama: Panama City
Papua Nuova Guinea: Port Moresby
Paraguay: Asunción
Perù: Lima
Filippine: Manila
Polonia: Varsavia
Portogallo: Lisbona
Qatar: Doha
Romania: Bucarest
Russia: Mosca
Ruanda: Kigali
St. Kitts e Nevis: Basseterre
Santa Lucia: Castries
St. Vincent e Grenadine: Kingstown
Samoa: Apia
San Marino: San Marino
São Tomé e Principe: São Tomé
Arabia Saudita: Riyadh
Senegal: Dakar
Serbia: Belgrado
Seychelles: Victoria
Sierra Leone: Freetown
Singapore, Singapore
Slovacchia: Bratislava
Slovenia: Lubiana
Isole Salomone: Honiara
Somalia: Mogadiscio
Sud Africa: Pretoria
Sud Sudan: Juba
Spagna: Madrid
Sri Lanka: Colombo
Sudan: Khartoum
Suriname: Paramaribo
Swaziland: Mbabane
Svezia: Stoccolma
Svizzera: Berna
Siria: Damasco
Taiwan: Taipei
Tagikistan: Dushanbe
Tanzania: Dodoma
Thailandia: Bangkok
Togo: Lomé
Tonga: Nuku'alofa
Trinidad e Tobago: Port-of-Spain
Tunisia: Tunisi
Turchia: Ankara
Turkmenistan: Ashgabat
Tuvalu: Funafuti
Uganda: Kampala
Ucraina: Kiev
Emirati Arabi Uniti: Abu Dhabi
Regno Unito: Londra
Stati Uniti: Washington, D.C.
USA: Washington, D.C.
Stati Uniti: Washington, D.C.
U S: Washington, D.C.
U S A: Washington, D.C.
America: Washington, D.C.
Uruguay: Montevideo
Uzbekistan: Tashkent
Vanuatu: Port Vila
Venezuela: Caracas
Vietnam: Hanoi
Yemen: Sanaá
Zambia Lusaka
Lo Zimbabwe: Harare
