indirizzo: indirizzo
Età: l'età
bambino:
bestfriend: bestfriend
Compleanno:
luogo di nascita: città natale
fidanzato: fidanzato
fratello: il fratello
gatto gatto
città: city
Paese: Paese
: County
figlia: figlia
cane Cane
e-mail: e-mail
datore di lavoro: datore di lavoro
padre: padre
attore preferito: favoriteactor
attrice preferita: favoriteactress
band preferita: favoriteband
libro preferito: favoritebook
auto preferita: favoritecar
colore preferito: favoriteColor
bevanda preferita: favoritedrink
cibo preferito: favoritefood
gelato preferito: favoriteicecream
film preferito: favoritemovie
canzone preferita: favoritesong
sport preferito: favoritesport
programma televisivo preferito: favoritetvshow
Nome: cognome
Amico:
genere: sesso
fidanzata: la fidanzata
nonno: nonno
nonna: la nonna
capelli:
ha: ha
marito: il marito
cognome: cognome
latitudine: la latitudine
piace: Mi piace
posizione: posizione
longitute: longitute
MiddleName: MiddleName
madre: la madre
il nipote: il nipote
la nipote: la nipote
orientamento: orientamento
Provincia: Provincia
la religione: la religione
Casa: Residenza
Strada: Strada
sorella: la sorella
Stato: Stato
Stato: Stato
strada: strada
città: città
moglie: la moglie

