perdonato: perdona
detto dire
sviluppato: sviluppare
ha spiegato: spiegare
affumicato: fumo
continuato: continua
ha parlato: parlate
rispose: risposta
iscritto: unire
rispetto: confronta
creato: creare
cominciai: inizio
considerato: per quanto riguarda
minded: mente
acquistato: acquistare
aperto: aperto
ha chiesto: chiedere
calcato: battistrada
svegliò: sveglia
ha detto: dire
promessa: la promessa
puliti: pulito
aggrappato: si aggrappano
eliminato: chiaro
bit: morso
fed: mangimi
lavata: lavata
organizzato: organizzare
soothsaid: soothsay
esistito: esistono
snuck: furtivo
guidato: unità
in onda: in onda
sped: Velocità
avvertito: warn
fatto fare
viaggiato: viaggio
visitato: visita
preoccupato: preoccupazione
è cresciuto: crescere
esaminato: esamina
sorrise: sorriso
agito: atto
a sinistra: lasciare
durata: dal vivo
bagnato: bagnato
impedito: prevenire
richiesto: la domanda
quivi: stand
goduto: godere
cantava: cantare
battere: battere
wed: Mer
proibì: vietare
affondò: sink
parlato: parlare
rotto: rottura
suonava: suono
introdotto: introdurre
ringraziato: Grazie
tornato: il ritorno
bound: bind
infilate: stringa
piallati: Piano
ha rivelato: rivelare
ha preso: prendere
soffermato: abitare
fondata: trovati
consisteva: consistono
calci: calcio
durata: ultima
avuto: hanno
dimostrato: dimostrare
forzata: la forza
battibecco: sputo
seminato: scrofa
raffica: raffica
Quaresima: prestare
sostituito: sostituire
preferito: Preferisco
deciso: decidere
coinvolti: coinvolgere
giocato: Gioca
rise: risata
si sforzò: si sforzano
frainteso: misunderstand
odore: odore
ottenuto: ottenere
chiesti: Meraviglia
set: set
previsto: previsioni
provato: provare
testato: Test
rubato: rubare
pubblicato: rilascio
incontrato: incontro
testa: testa
inginocchiato: inginocchiarsi
contribuito: contribuire
bussato: colpo
toccata: touch
formato: modulo
addestrato: treno
apparso: appaiono
raggiunto: raggiungere
ha esultato: salto
lay: lie
oscillato: altalena
finito: finitura
indicazione: informare
spostato: mossa
capannone: capannone
atteso: si aspettano
rasata: radersi
Ran: run
tore: tear
puzzava: puzza
danneggiati: danni
cucito: cucire
Fell: caduta
trasportato: trasportare
riposato: resto
Rode: corsa
migliorata: migliorare
confermato: conferma
squillato: Anello
influenzato: influenza
segnalati: rapporto
prosperato: prosperare
misurata: misura
appuntita: Punto
volato: volare
rosa: aumento
immaginato: immaginate
gestito: gestire
fuggito: fuga
commesso: commit
sperato: la speranza
esperto: esperienza
eseguito: eseguire
registrati: record di
incrociati: croce
votato: voto
scosse: shake
frostbit: congelamento
sollevato: aumentare
pensiero pensato
verificato: si verificano
quit: quit
seguita: seguire
ferita: vento
tosato: shear
guadagnato: Guadagno
udito: sentire
distrutta: distruggere
supportato: Supporto
chiuso: chiudi
pubblicato: pubblicare
costruzione: costruire
finalizzato: obiettivo
mantenuta: tenere
completato: completa
tenuto: tenere
raccolta: raccogliere
atteso: attendere
negato: negare
preoccupato: preoccupazione
taglia taglia
descritto: descrivere
ha dichiarato: Stato
HID: nascondere
flung: Fling
cotta: cuoco
caccia: caccia
causato: causa
cambiato: il cambiamento
correlati: RELATE
contattato: contatto
bruciata dal sole: scottature
colpire: colpire
passeggiato: escursione
superato: sorpasso
richiesta: richiedono
copiato: copy
piaciuto: come
controllata controllo
significava: media
di proprietà: proprio
studiati: studio
risolta: accontentarsi
scommessa: scommessa
chiamato: Chiamata
inclusi: includere
riconosciuto: riconoscere
perso perdere
ascoltato: ascolta
subito: soffrire
considerato: prendere in considerazione
era: essere
spazzato: spazzata
raggiunto: realizzare
ritirato: ritirare
tracolla: sling
intrapreso: intraprendere
vestita: vestire
sembrava: sembrano
resistito: resistere
leggi leggi
trattati: trattare
bloccato: bastone
prevedeva: Foresee
preset: preset
speso: spendere
offerta: offerta
slunk: slink
aggiunto: aggiungi
laminati: rotolo
amato: l'amore
curato: tendono
ha insegnato: insegnare
montato: fit
male male
sentito: feel
guardato: cerca
combattuto: lotta
sprang: spring
adatto: tuta
rimosso: rimuovi
discusso: discutere
Spread: spread
rimasto: restano
impiccato: appendere
trovato Trovare
limitata: limite
passato: passaggio
ha scritto: scrivere
sapeva: Know
ricevuto: ricevere
scomparso: scompaiono
soffiò: colpo
ha mostrato: spettacolo
ballato: ballo
ridotto: ridurre
Bled: bleed
dimenticavo dimenticare
ridded: liberarsi
subaffittare: subaffittare
ha ammesso: ammettere
è diventato: diventare
indicata: indicare
alighted: scendere
caduto: goccia
: Spalato
di cui: consultare
sudore: il sudore
realizzato: realizzare
offerta: offerta
uccisi: uccidere
strode: falcata
rimasto: rimanere
alesaggio: Orso
ricercato: chiedere
portato: portare
notato: avviso
progettati: il design
handwrote: scrivere a mano
lavorato: il lavoro
lamentava: lamentano
rappresentato: conto
catturato: catch
insinuato: scorrimento
vestito: vestito
suggerito: suggeriscono
fornito: fornitura
fissato: Fissi
prodotto: la produzione
ripetuto: repeat
ha dato: dare
scelto: selezionamento
pescato: pesce
spogliato: striscia
di cui: lay
verificati: Controllo
invitati: invitare
scoperto: scopri
busto: busto
corretta: corretto
a maglia: maglia
riflessa: riflettere
supposto: supponiamo
scalato: salita
attaccato: attacco
servito: servire
identificato: identificare
gestito: gestire
colpiti: influenzare
svegliato: Wake
affrontato: face
capito: capire
punse: pungere
presentato: presenti
In comune: la quota
bruciate: bruciare
enabled: abilita
d'accordo: d'accordo
attenuto: rispettare
navigato: Surf
salvato: salva
splendeva: shine
destinato: l'intenzione
costo: Costo
carica: carica
dove: dive
spun: spin
applaudito: clap
farro: incantesimo
getto: cast
sostenuto: Argue
sopravvissuto: sopravvivere
scavato: dig
ottenuto: ottenere
riuscito: successo
mistook: errore
immessa: Ingresso
colpito: sciopero
chiuso: chiuso
sorse: sorgono
rispose: rispondere
posto: posto
di spinta: spinta
consegnato: consegnare
allevato: razza
ordinato: sort
risultato: risultato
esteso: estendere
aiutato: aiutare
acquisti: negozio
importava: la materia
evitare: Evitare
necessario: necessità
contati: count
ordinato: ordine
imparato: imparare
sfilza: slay
condizione: fornire
interlacciata: interlay
giurò: swear
appoggiò: magra
bent: curva
falciato: falciare
gonfiato: swell
contrariata: Vex
shrank: shrink
pieno: riempire
è andato: go
viziato: rovinare
accettati: accetta
rappresentata: rappresentano
dormiva: il sonno
arrivato: arrivare
rifiutato: rifiuti
scivolato: slide
caned: può
venduti: vendere
strizzato: strizzare
ha fatto
successo: accadere
fermato: stop
sat: SIT
desiderato: desiderare
sega: vedi
diviso: dividere
gridò: cry
wove: tessuto
metti metti
premuto: stampa
incoraggiato: incoraggiare
contemplato: ecco
sognato: sogno
fallito: fail
terra: grind
separate: separata
menzionato: menzione
pianse: piangete
osato: osare
voluto: want
guardato: orologio
volontà: volontà
creduto: credere
a pagamento: pagare
sconvolto: sconvolto
gridò: grido
coperta: la copertura
predetto: predire
sentito: origliare
offerta: permettersi
camminato: camminare
lasciare: lasciare
fessura: slit
intarsiato: intarsio
led: piombo
sottoposti: sottopongono
saltato: salto
piegata: fold
base: base
consentito: consentire
apparteneva: appartengono
odiato: odio
collegato: collegare
rovesciato: spill
utilizzato: l'uso
colpo: sparare
curato: la cura
spedito spedire
girato: turno
segato: sega
morto: die
calzati: shoe
Drew: draw
collegato: Link
segnato: mark
espresso: esprimere
ha scelto: scegli
dipendeva: depend
trattenuto: trattenere
gettato: tiro
indossava: usura
preparati: preparare
aumentato: aumento
fuorviato: indurre in errore
contenuto: contengono
abbandonarono: abbandonare
protetta: proteggere
congelato: freeze
overdrew: overdraw
mangiato: mangiare
vinto: vittoria
fusa: melt
tirato: tirare
Lit: la luce
trattati: affare
è venuto: vengono
bevuto: drink
applicata: applicare
ricordato: ricordare
nuotato: swim
spinta: spinta
rivendicato: reclamo
avviato: inizio
perdere: Miss
