ALERT=Attenzione! Per favore, stammi a sentire
ARDUINONOTCONNECTED=Problema con la porta di comunicazione, esamina Arduino e correggi
BADMRLCOMMVERSION=Arduino contiene una versione sbagliata dell' MRL. Per favore, fai un up-date e correggila
BADSHUTDOWN=Attenzione! Il mio cervello è stato danneggiato , forse per uno spegnimento errato.Non preoccuparti, rimetterò in ordine  tutti i miei file a. i. m. l .
CHATBOTACTIVATED= Ho caricato il programma di conversazione,forse dovrò attivare altri componenti.Aspetta un momento, per favore
CHATBOTERROR=Il codice di chatbot non è in grado di partire perchè non ho trovato il dizionario  della tua lingua
CHATBOTLOADING=Sto caricando il mio cervello, per favore aspetta
MOUTHSYNCRONISATION=Sincronizzazione automatica dei movimenti labiali basata sul segnale audio
MOUTHSYNCRONISATIONBAD=Non ho rilevato  sulla porta analogica  un segnale audio sufficiente
MOUTHSYNCRONISATIONNOTPERFECT=Ho rilevato un segnale audio ma non è un segnale perfetto.Occorre controllare aref arduino.Non preoccuparti, lo faremo funzionare 
MOUTHSYNCRONISATIONOK=Bene, guarda le mie labbra: si muovono
NEOPIXELNOWORKY=C'è un problema con neopixel , controlla la connessione ed il protocollo m r l com
OPENCVNOWORKY=Open ceve non parte perchè  ha un problema
OPENNINOWORKY=Kinect open n i non parte.Controlla microsoft kinect s. d. k.
READY=OK,sono pronto ad eseguire  i tuoi ordini
SHUTDOWN=Sto  chiudendo completamente il mio programma, per favore ,aspetta: ci vorranno  dieci secondi
STARTINGEAR=Attivo gli  orecchi
STARTINGEYELIDS=Attivo le palpebre
STARTINGHEAD=Attivo la testa
STARTINGLEFTARM=Attivo il braccio sinistro
STARTINGLEFTHAND=Attivo la mano sinistra
STARTINGMOUTH=Attivo la bocca
STARTINGNEOPIXEL=Attivo il Neo Pixel
STARTINGOPENCV=Accendo la videocamera
STARTINGOPENNI=Kinetics è acceso
STARTINGPIR=Attivo il sensore P.I.R.
STARTINGRIGHTARM=Attivo il braccio destro
STARTINGRIGHTHAND=Attivo la mano destra
STARTINGROLLNECK=Attivo i movimenti del collo
STARTINGTORSO=Attivo il busto
STARTINGULTRASONIC=Attivo il sensore ultrasonico
STARTINGVIRTUAL=InMoov virtuale attivato
TRACKINGSTARTED=Attivo la localizzazione