ALERT=ACHTUNG! bitte zuhören!
ARDUINONOTCONNECTED=Es gibt ein Problem mit der Verbindung zu den Arduinos, bitte prüfen
BADMRLCOMMVERSION=Nicht passende M R L version in den Arduinos entdeckt, bitte nachführen
BADSHUTDOWN=Alert ! My brain is corrupted, maybe a bad shutdown? Dont worry I will recompile a. i. m. l. files.
CHATBOTACTIVATED=Dialogsystem bereit, jetzt weitere Komponenten starten
CHATBOTERROR=Das Dialogsystem kann nicht gestartet werden, kein Sprachverzeichnis gefunden
CHATBOTLOADING=Ich aktiviere mein Hirn, das dauert etwas
MOUTHSYNCRONISATION=Automatische Synchronisierung des Mundes mit dem Audio Signal
MOUTHSYNCRONISATIONBAD=Kein zuverlässiges Audio Signal erkannt,
MOUTHSYNCRONISATIONNOTPERFECT=Schwaches Audio Signal.
MOUTHSYNCRONISATIONOK=Gut, schau auf meine Lippen, sie bewegen sich
NEOPIXELNOWORKY=Es gibt ein Problem mit dem neopixel , bitte Verbindung und logeinträge prüfen
OPENCVNOWORKY=Kamera kann nicht aktiviert werden
OPENNINOWORKY=Kinect kann nicht aktiviert werden
READY=Ok, ich bin bereit
SHUTDOWN=Löschung meines Systems
STARTINGEAR=Ich öffne meine Ohren
STARTINGEYELIDS=Augenlieder aktiviert
STARTINGHEAD=Kopf aktiviert
STARTINGLEFTARM=Linker Arm aktiviert
STARTINGLEFTHAND=Linke Hand aktiviert
STARTINGMOUTH=Stimme aktiviert
STARTINGNEOPIXEL=neo pixel aktiviert
STARTINGOPENCV=Kamera aktiviert
STARTINGOPENNI=Kinect aktiviert
STARTINGPIR=p,i,r sensor activiert
STARTINGRIGHTARM=Rechter Arm aktiviert
STARTINGRIGHTHAND=Rechte Hand aktiviert
STARTINGROLLNECK=Rollneck aktiviert
STARTINGTORSO=Torso aktiviert
STARTINGULTRASONIC=Ultraschallsensor starten
STARTINGVIRTUAL=virtueller inmoov wird gestartet
TRACKINGSTARTED=tracking aktiviet