ALERT=Alert! Mag ik je aandacht alsjeblieft !
ARDUINONOTCONNECTED=Er is een probleem ! Met mijn communicatie poort, controleer je arduino
BADMRLCOMMVERSION=Slechte M R L com versie binnen arduino, aub update
BADSHUTDOWN=Alert ! My brain is corrupted, maybe a bad shutdown? Dont worry I will recompile a. i. m. l. files.
CHATBOTACTIVATED=Chatbot geladen, ik kan andere componenten starten, even geduld aub
CHATBOTERROR=De chatbot kan niet starten omdat ik geen woordenboek over uw taal heb gevonden
CHATBOTLOADING=Ik laad mijn hersenen, wacht alstublieft
MOUTHSYNCRONISATION=Automatische synchronisatie van mijn mond, gebaseerd op audiosignaal
MOUTHSYNCRONISATIONBAD=Ik heb geen goed audiosignaal op de analoge poort gedetecteerd ,
MOUTHSYNCRONISATIONNOTPERFECT=Ik detecteer een audiosignaal, maar het is niet perfect. Check aref arduino. Maak je geen zorgen, het zal handig zijn
MOUTHSYNCRONISATIONOK=Leuk, kijk naar mijn lippen, ze zijn aan het bewegen
NEOPIXELNOWORKY=Er is een probleem met neopixel, controleer de verbinding en het protocol van m.r.l Com
OPENCVNOWORKY=Open ceve kan niet starten, er is een probleem met het
OPENNINOWORKY=Kinect open n i , kan niet starten
READY=Oké, je hebt mijn aandacht
SHUTDOWN=uitsterven van mijn systeem
STARTINGEAR=Startende oren
STARTINGEYELIDS=Start oogleden
STARTINGHEAD=Startkop
STARTINGLEFTARM=Startende linkerarm
STARTINGLEFTHAND=Met linkerhand beginnen
STARTINGMOUTH=Begin van de mond
STARTINGNEOPIXEL=Neo pixel Service starten
STARTINGOPENCV=open c.v. Camera, klaar
STARTINGOPENNI=Kinect, klaar
STARTINGPIR=p,i,r Sensor activering
STARTINGRIGHTARM=Start rechterarm
STARTINGRIGHTHAND=Met de rechterhand beginnen
STARTINGROLLNECK=Startrol nek
STARTINGTORSO=Torso starten
STARTINGULTRASONIC=to translate Starting ultrasonic sensor
STARTINGVIRTUAL=Virtuele inmoov geactiveerd
TRACKINGSTARTED=Beginnen met tracking