ALERT=Предупреждение! Пожалуйста, слушайте меня внимательно.
ARDUINONOTCONNECTED=Существует проблема! С моим портом связи, проверьте свою ардуину.
BADMRLCOMMVERSION=Загружена неправильная версия скетча М.Р.Л. ком. в Ардуино. Обновите пожалуйста М.Р.Л. версию внутри ардуино.
BADSHUTDOWN=Мой интелект не работает,неправильно выгрузили мою систему. Я перекомпилирую файлы a. i. m. l.
CHATBOTACTIVATED=Чатбот загружен, я запускаю другие компоненты, пожалуйста, подождите
CHATBOTERROR=Чатбот не может стартовать, потому что я не нашел словаря о вашем языке.
CHATBOTLOADING=Я загружаю файлы для работы искусственного интеллекта, пожалуйста, подождите
MOUTHSYNCRONISATION=Автоматическая синхронизация моего рта, основанная на звуковом сигнале.
MOUTHSYNCRONISATIONBAD=Я не обнаружил хорошего аудиосигнала на аналоговом порту.
MOUTHSYNCRONISATIONNOTPERFECT=Я обнаружил аудиосигнал, но он не идеален. Проверьте пин в ардуино. Не беспокойтесь, это будет работать.
MOUTHSYNCRONISATIONOK=Хорошо, посмотрите на мои губы, они двигаются.
NEOPIXELNOWORKY=Есть проблема с неопикселем, проверьте соединение и протокол М.Р.Л. ком.
OPENCVNOWORKY=ОПЭН ЦВ не может запуститься, есть проблема.
OPENNINOWORKY=КИНЕКТ ОПЭН НИ, не может запуститься, есть проблема.
READY=Я готов работать
SHUTDOWN=Отключаю систему, пожалуйста, подождите
STARTINGEAR=Запускаю уши
STARTINGEYELIDS=Запускаю управление глаз
STARTINGHEAD=Запускаю управление головы
STARTINGLEFTARM=Запускаю управление левого плеча
STARTINGLEFTHAND=Запускаю управление левой руки
STARTINGMOUTH=Запускаю управление рта
STARTINGNEOPIXEL=Запуск службы нео пиксель
STARTINGOPENCV=Запускаю ОПЭН ЦВ. Камера проверена
STARTINGOPENNI=Запускаю КИННЕКТ
STARTINGPIR=Активация датчика ПИР
STARTINGRIGHTARM=Запускаю управление правого плеча
STARTINGRIGHTHAND=Запускаю управление правой руки
STARTINGROLLNECK=Запускаю управление шеи
STARTINGTORSO=Запускаю управление торса
STARTINGULTRASONIC=Запускаю ультразвуковой датчик
STARTINGVIRTUAL=Виртуальный инмоов активирован
TRACKINGSTARTED=Начинаю отслеживание