ALERT=Alerte ! Veuillez m'écouter attentivement
ARDUINONOTCONNECTED=J'ai un problème avec le port com de l'arduino
BADMRLCOMMVERSION=Mauvaise version du sketch m r l com dans votre arduino
BADSHUTDOWN=Alerte ! Mon cerveau est corrompu, certainement une mauvaise extinction de mon système. Je vais recompiler les fichier a. i. m. l.
CHATBOTACTIVATED=Chatebote activé
CHATBOTERROR=Le chatbot ne peut pas démarrer car votre dictionaire est absent
CHATBOTLOADING=Je charge les fichiers de mon intelligence artificielle, veuillez patienter
MOUTHSYNCRONISATION=Je syncronise ma bouche automatiquement, en me basant sur le signal audio
MOUTHSYNCRONISATIONBAD=maousse controle désactivé Je n'ai détecté auqun signal audio de qualité sur le port,
MOUTHSYNCRONISATIONNOTPERFECT=J'ai détecté un signal audio mais ce n'est pas parfait, problème d'arèfe de  l'arduino
MOUTHSYNCRONISATIONOK=OK maousse controle activé
NEOPIXELNOWORKY=Il y a un problème avec le neopixel, vérifier la connection et la version de m r l com
OPENCVNOWORKY=Opène cévé ne peut pas démarrer
OPENNINOWORKY=Kinect opène n i , ne peut pas démarrer. avez vous installé le s. d. k. kinect de microsoft?
READY=Je suis prêt à fonctionner
SHUTDOWN=extinction de mon systaime, veuillez patienter 10 secondes
STARTINGEAR=reconnaissance vocale, oké
STARTINGEYELIDS=démarrage des paupières
STARTINGHEAD=démarrage de la tête
STARTINGLEFTARM=démarrage du bras gauche
STARTINGLEFTHAND=démarrage de la main gauche
STARTINGMOUTH=bouche, oké
STARTINGNEOPIXEL=neo pixel, oké
STARTINGOPENCV=opeune cévé caméra, oké
STARTINGOPENNI=Kinect, oké
STARTINGPIR=capteur de présence, oké
STARTINGRIGHTARM=démarrage du bras droit
STARTINGRIGHTHAND=démarrage de la main droite
STARTINGROLLNECK=démarrage du rollneck mode
STARTINGTORSO=démarrage du Torse
STARTINGULTRASONIC=démarrage Capteur à ultrasons
STARTINGVIRTUAL=Mode inmoov virtuel
TRACKINGSTARTED=tracking service démarré