ALERT=Hälytys, voinko kiinnittää huomionne!
ARDUINONOTCONNECTED=On olemassa ongelma! viestintäporttini, tarkista arduino
BADMRLCOMMVERSION=Bad M R L com -versio sisällä arduino, päivitä
BADSHUTDOWN=Alertti, aivoni on vioittunut, ehkä huono shutdown?
CHATBOTACTIVATED=Chatbot ladattu, voin käynnistää muita komponentteja, odota
CHATBOTERROR=Chatbot ei voi käynnistää, koska en löytänyt sanastoa omasta kielestäsi
CHATBOTLOADING=Minä lataan aivoni, odota
MOUTHSYNCRONISATION=Suun synkronointi automaattisesti äänisignaalin perusteella
MOUTHSYNCRONISATIONBAD=En havaitsi yhtään hyvää äänisignaalia analogisessa portissa,
MOUTHSYNCRONISATIONNOTPERFECT=Tunnistan äänisignaalin, mutta se ei ole täydellinen Tarkista aref arduino, älä huoli siitä, että se on työläs
MOUTHSYNCRONISATIONOK=Nizza, katso huuliani, he liikkuvat
NEOPIXELNOWORKY=ongelma on neopikselin kanssa, tarkista yhteys ja m r l com -protokolla
OPENCVNOWORKY=Avaa Ceve ei voi käynnistää, ongelma,
OPENNINOWORKY=Kinect avoinna n, ei voi aloittaa. Tarkista microsoft kinect s. d. k.
READY=Ok, sinulla on minun huomioni
SHUTDOWN=Sammuta järjestelmäni, odota 10 sekuntia
STARTINGEAR=Korvien aloitus
STARTINGEYELIDS=Aloittaminen silmäluomien
STARTINGHEAD=Aloituspään
STARTINGLEFTARM=Vasemman käden aloitus
STARTINGLEFTHAND=Vasemmanpuoleinen käsi
STARTINGMOUTH=Aloittavan suun
STARTINGNEOPIXEL=Aloita neopikselipalvelu
STARTINGOPENCV=avaa c.v. kamera, valmis
STARTINGOPENNI=Kinect, aloitettu
STARTINGPIR=p, i, r anturin aktivointi
STARTINGRIGHTARM=Oikean käden aloitus
STARTINGRIGHTHAND=Oikeanpuoleinen käsi
STARTINGROLLNECK=Aloita telan kaula
STARTINGTORSO=Aloitus Torso
STARTINGULTRASONIC=Käynnistys ultraäänianturilla
STARTINGVIRTUAL=virtuaalinen inmoov aktivoitu
TRACKINGSTARTED=aloittavan seurannan