ALERT=¡Alerta!  ¡Preste atención por favor!
ARDUINONOTCONNECTED=Tengo un problema con el puerto COM de Arduino, compruébelo.
BADMRLCOMMVERSION=Arduino tiene una versión incorrecta de M R L com, por favor actualice.
BADSHUTDOWN=Alert ! My brain is corrupted, maybe a bad shutdown? Dont worry I will recompile a. i. m. l. files.
CHATBOTACTIVATED=Chatbot Activado, Ahora estoy listo
CHATBOTERROR=El chatbot no puede ejecutarse porque no se encuentra el diccionario de su idioma
CHATBOTLOADING=Cargando Inteligencia Artificial, Por favor, espere un momento
MOUTHSYNCRONISATION=Mi boca se sincroniza automáticamente con la señal de audio ,
MOUTHSYNCRONISATIONBAD=No detecto una buena señal de audio en el puerto analógico ,
MOUTHSYNCRONISATIONNOTPERFECT=Detecto una señal de audio pero no es perfecta. Verifique el pin aref de arduino. no se preocupe, se resolverá
MOUTHSYNCRONISATIONOK=Muy bien, Mire mis labios, se están moviendo
NEOPIXELNOWORKY=Il y a un problème avec le neopixel
OPENCVNOWORKY=Open ceve problemas
OPENNINOWORKY=Kinect open n i , cannot start
READY=Muy bien, lo estoy escuchando
SHUTDOWN=apagando mi sistema
STARTINGEAR=Iniciando oídos
STARTINGEYELIDS=to translate Starting eyelids
STARTINGHEAD=Iniciando la cabeza
STARTINGLEFTARM=Iniciando el brazo izquierdo
STARTINGLEFTHAND=Iniciando la mano izquierda
STARTINGMOUTH=Iniciando la boca
STARTINGNEOPIXEL=Iniciando el servicio Neo Pixel
STARTINGOPENCV=to translate open c.v. camera, okay
STARTINGOPENNI=to translate Kinect, started
STARTINGPIR=pir sensor activation
STARTINGRIGHTARM=Iniciando el brazo derecho
STARTINGRIGHTHAND=Iniciando la mano derecha
STARTINGROLLNECK=Iniciando servo de movimiento del cuello
STARTINGTORSO=Iniciando el torso
STARTINGULTRASONIC=to translate Starting ultrasonic sensor
STARTINGVIRTUAL=to translate virtual inmoov mode
TRACKINGSTARTED=to translate tracking service started